▄▄▄▄▄▄▄▄▄▄▄▄▄▄▄▄▄▄▄▄▄▄▄▄▄▄▄▄▄▄▄▄▄▄▄▄▄▄▄▄▄▄▄▄▄▄▄▄▄▄▄▄▄▄▄▄▄▄▄▄▄▄▄▄▄▄▄▄▄▄▄▄▄▄▄▄▄▄▄▄▄▄▄▄▄▄▄▄▄▄▄▄▄▄▄▄▄▄▄▄▄▄▄▄▄▄▄▄▄▄▄▄▄▄▄▄▄▄▄▄▄▄▄▄▄▄▄▄▄▄▄▄▄▄▄▄▄▄▄▄▄▄▄▄▄▄▄▄▄▄▄▄▄▄▄▄▄▄▄▄▄▄▄▄▄▄▄▄▄▄▄▄▄▄▄▄▄▄▄▄▄▄▄▄▄▄▄▄▄▄▄
█            █    ║░░░░░░░░░░║░░░░░░░░░░║░░░░░░░░░░║░░░░░░░░░░║░░░░░░░░░░║░░░░░░░░░░║░░░░░░░░░░║░░░░░░░░░░║░░░░░░░░░░║░░░░░░░░░░║░░░░░░░░░░║░░░░░░░░░░║░░░░░░░░░░║░░░░░░░░░░║    █            █
█            █    ╠══════════╬══════════╬══════════╬══════════╬══════════╬══════════╬══════════╬══════════╬══════════╬══════════╬══════════╬══════════╬══════════╬══════════╣    █            █
█            █    ║          ║          ║          ║          ║          ║          ║          ║          ║          ║          ║          ║          ║          ║          ║    █            █
█            █    ║          ║          ║          ║          ║          ║          ║          ║          ║          ║          ║          ║          ║          ║          ║    █            █
█▄▄▄▄▄▄▄▄▄▄▄▄█    ║          ║          ║          ║          ║          ║          ║          ║          ║          ║          ║          ║          ║          ║          ║    █▄▄▄▄▄▄▄▄▄▄▄▄█
█                 ║          ║          ║          ║          ║          ║          ║          ║          ║          ║          ║          ║          ║          ║          ║                 █
█══╦══════════                                                                                                                                                                   ══════════╦══█
█░░║                                                                                                                                                                                       ║░░█
█░░║                                                                                                                                                                                       ║░░█
█══╬══════════                                                                                                                                                                   ══════════╬══█
█░░║                                                                                                                                                                                       ║░░█
█░░║                                                                                                                                                                                       ║░░█
█══╬══════════                                                      ║          ║          ║          ║          ║          ║                                                     ══════════╬══█
█░░║                                                                ║          ║          ║          ║          ║          ║                                                               ║░░█
█░░║                                                                ║          ║          ║          ║          ║          ║                                                               ║░░█
█░░║                                                                ║          ║          ║          ║          ║          ║                                                               ║░░█
█░░║                                                                ╠══════════╬══════════╬══════════╬══════════╬══════════╣                                                               ║░░█
█══╬══════════                                                      ║░░░░░░░░░░║░░░░░░░░░░║░░░░░░░░░░║░░░░░░░░░░║░░░░░░░░░░║                                                     ══════════╬══█
█░░║                                                            ▀▀▀▀▀▀▀▀▀▀▀▀▀▀▀▀▀▀▀▀▀▀▀▀▀▀▀▀▀▀▀▀▀▀▀▀▀▀▀▀▀▀▀▀▀▀▀▀▀▀▀▀▀█▀▀▀▀▀▀▀▀▀█                                                           ║░░█
█░░║                                                                                                                 │         █══╦══════════                                              ║░░█
█░░║                                                                                                                 │         █░░║                                                        ║░░█
█░░║                                                                                           <────────────         │         █░░║                                                        ║░░█
█══╬══════════                                                                                                       │         █══╬══════════                                    ══════════╬══█
█░░║                                                                                                                 │         █░░║                                                        ║░░█
█░░║                                                              ───────────────────────────────────────────────────┼─────────█░░║                                                        ║░░█
█░░║                                                                                                                 │         █══╬══════════                                              ║░░█
█░░║                                                                                                                 │         █░░║                                                        ║░░█
█══╬══════════                                                                                 ────────────>         │         █░░║                                              ══════════╬══█
█░░║                                                                                                                 │         █══╩══════════                                              ║░░█
█░░║                                                                                                                 │         █                                                           ║░░█
█░░║                                                            ▄▄▄▄▄▄▄▄▄▄▄▄▄▄▄▄▄▄▄▄▄▄▄▄▄▄▄▄▄▄▄▄▄▄▄▄▄▄▄▄▄▄▄▄▄▄▄▄▄▄▄▄▄█▄▄▄▄▄▄▄▄▄█                                                           ║░░█
█░░║                                                                ║░░░░░░░░░░║░░░░░░░░░░║░░░░░░░░░░║░░░░░░░░░░║░░░░░░░░░░║                                                               ║░░█
█══╬══════════                                                      ╠══════════╬══════════╬══════════╬══════════╬══════════╣                                                     ══════════╬══█
█░░║                                                                ║          ║          ║          ║          ║          ║                                                               ║░░█
█░░║                                                                ║          ║          ║          ║          ║          ║                                                               ║░░█
█░░║                                                                ║          ║          ║          ║          ║          ║                                                               ║░░█
█░░║                                                                ║          ║          ║          ║          ║          ║                                                               ║░░█
█══╬══════════                                                                                                                                                                   ══════════╬══█
█░░║                                                                                                                                                                                       ║░░█
█░░║                                                                                                                                                                                       ║░░█
█░░║                                                                                                                                                                                       ║░░█
█░░║                                                                                                                                                                                       ║░░█
█══╩══════════                                                                                                                                                                   ══════════╩══█
█                 ║          ║          ║          ║          ║          ║          ║          ║          ║          ║          ║          ║          ║          ║          ║                 █
█▀▀▀▀▀▀▀▀▀▀▀▀█    ║          ║          ║          ║          ║          ║          ║          ║          ║          ║          ║          ║          ║          ║          ║    █▀▀▀▀▀▀▀▀▀▀▀▀█
█            █    ║          ║          ║          ║          ║          ║          ║          ║          ║          ║          ║          ║          ║          ║          ║    █            █
█            █    ║          ║          ║          ║          ║          ║          ║          ║          ║          ║          ║          ║          ║          ║          ║    █            █
█            █    ╠══════════╬══════════╬══════════╬══════════╬══════════╬══════════╬══════════╬══════════╬══════════╬══════════╬══════════╬══════════╬══════════╬══════════╣    █            █
█            █    ║░░░░░░░░░░║░░░░░░░░░░║░░░░░░░░░░║░░░░░░░░░░║░░░░░░░░░░║░░░░░░░░░░║░░░░░░░░░░║░░░░░░░░░░║░░░░░░░░░░║░░░░░░░░░░║░░░░░░░░░░║░░░░░░░░░░║░░░░░░░░░░║░░░░░░░░░░║    █            █
▀▀▀▀▀▀▀▀▀▀▀▀▀▀▀▀▀▀▀▀▀▀▀▀▀▀▀▀▀▀▀▀▀▀▀▀▀▀▀▀▀▀▀▀▀▀▀▀▀▀▀▀▀▀▀▀▀▀▀▀▀▀▀▀▀▀▀▀▀▀▀▀▀▀▀▀▀▀▀▀▀▀▀▀▀▀▀▀▀▀▀▀▀▀▀▀▀▀▀▀▀▀▀▀▀▀▀▀▀▀▀▀▀▀▀▀▀▀▀▀▀▀▀▀▀▀▀▀▀▀▀▀▀▀▀▀▀▀▀▀▀▀▀▀▀▀▀▀▀▀▀▀▀▀▀▀▀▀▀▀▀▀▀▀▀▀▀▀▀▀▀▀▀▀▀▀▀▀▀▀▀▀▀▀▀▀▀▀▀▀▀