▄▄▄▄▄▄▄▄▄▄▄▄▄▄▄▄▄▄▄▄▄▄▄▄▄▄▄▄▄▄▄▄▄▄▄▄▄▄▄▄▄▄▄▄▄▄▄▄▄▄▄▄▄▄▄▄▄▄▄▄▄▄▄▄▄▄▄▄▄▄▄▄▄▄▄▄▄▄▄▄▄▄▄▄▄▄▄▄▄▄▄▄▄▄▄▄▄▄▄▄▄▄▄▄▄▄▄▄▄▄▄▄▄▄▄▄▄▄▄▄▄▄▄▄▄▄▄▄▄▄▄▄▄▄▄▄▄▄▄▄▄▄▄▄▄▄▄▄▄▄▄▄▄▄▄▄▄▄▄▄▄▄▄▄▄▄▄▄▄▄▄▄▄▄
█            █ ║░░░░░░░░░░║░░░░░░░░░░║░░░░░░░░░░║░░░░░░░░░░║░░░░░░░░░░║░░░░░░░░░░║░░░░░░░░░░║░░░░░░░░░░║░░░░░░░░░░║░░░░░░░░░░║░░░░░░░░░░║░░░░░░░░░░║░░░░░░░░░░║ █            █
█            █ ╠══════════╬══════════╬══════════╬══════════╬══════════╬══════════╬══════════╬══════════╬══════════╬══════════╬══════════╬══════════╬══════════╣ █            █
█            █ ║          ║          ║          ║          ║          ║          ║          ║          ║          ║          ║          ║          ║          ║ █            █
█            █ ║          ║          ║          ║          ║          ║          ║          ║          ║          ║          ║          ║          ║          ║ █            █
█▄▄▄▄▄▄▄▄▄▄▄▄█ ║          ║          ║          ║          ║          ║          ║          ║          ║          ║          ║          ║          ║          ║ █▄▄▄▄▄▄▄▄▄▄▄▄█
█              ║          ║          ║          ║          ║          ║          ║          ║          ║          ║          ║          ║          ║          ║              █
█                                                                                                                                                                            █
█══╦══════════                                                                                                                                                   ═════════╦══█
█░░║                                                                                                                                                                      ║░░█
█░░║                                                                                                                                                                      ║░░█
█══╬══════════                                                                                                                                                   ═════════╬══█
█░░║                                                               ║          ║          ║          ║          ║          ║                                               ║░░█
█░░║                                                               ║          ║          ║          ║          ║          ║                                               ║░░█
█══╬══════════                                                     ║          ║          ║          ║          ║          ║                                     ══════════╬══█
█░░║                                                               ║          ║          ║          ║          ║          ║                                               ║░░█
█░░║                                                               ╠══════════╬══════════╬══════════╬══════════╬══════════╣                                               ║░░█
█░░║                                                               ║░░░░░░░░░░║░░░░░░░░░░║░░░░░░░░░░║░░░░░░░░░░║░░░░░░░░░░║                                               ║░░█
█░░║                                                           ▀▀▀▀▀▀▀▀▀▀▀▀▀▀▀▀▀▀▀▀▀▀▀▀▀▀▀▀▀▀▀▀▀▀▀▀▀▀▀▀▀▀▀▀▀▀▀▀▀▀▀▀▀█▀▀▀▀▀▀▀▀▀█                                           ║░░█
█══╬══════════                                                                                                      │         █══╦══════════                    ══════════╬══█
█░░║                                                                                                                │         █░░║                                        ║░░█
█░░║                                                                                          <────────────         │         █░░║                                        ║░░█
█░░║                                                                                                                │         █══╬══════════                              ║░░█
█░░║                                                             ───────────────────────────────────────────────────┼─────────█░░║                                        ║░░█
█══╬══════════                                                                                                      │         █══╬══════════                    ══════════╬══█
█░░║                                                                                                                │         █░░║                                        ║░░█
█░░║                                                                                          ────────────>         │         █░░║                                        ║░░█
█░░║                                                                                                                │         █══╩══════════                              ║░░█
█░░║                                                           ▄▄▄▄▄▄▄▄▄▄▄▄▄▄▄▄▄▄▄▄▄▄▄▄▄▄▄▄▄▄▄▄▄▄▄▄▄▄▄▄▄▄▄▄▄▄▄▄▄▄▄▄▄█▄▄▄▄▄▄▄▄▄█                                           ║░░█
█══╬══════════                                                     ║░░░░░░░░░░║░░░░░░░░░░║░░░░░░░░░░║░░░░░░░░░░║░░░░░░░░░░║                                     ══════════╬══█
█░░║                                                               ╠══════════╬══════════╬══════════╬══════════╬══════════╣                                               ║░░█
█░░║                                                               ║          ║          ║          ║          ║          ║                                               ║░░█
█░░║                                                               ║          ║          ║          ║          ║          ║                                               ║░░█
█░░║                                                               ║          ║          ║          ║          ║          ║                                               ║░░█
█══╬══════════                                                     ║          ║          ║          ║          ║          ║                                     ══════════╬══█
█░░║                                                                                                                                                                      ║░░█
█░░║                                                                                                                                                                      ║░░█
█░░║                                                                                                                                                                      ║░░█
█░░║                                                                                                                                                                      ║░░█
█══╩══════════                                                                                                                                                  ══════════╩══█
█              ║          ║          ║          ║          ║          ║          ║          ║          ║          ║          ║          ║          ║          ║              █
█▀▀▀▀▀▀▀▀▀▀▀▀█ ║          ║          ║          ║          ║          ║          ║          ║          ║          ║          ║          ║          ║          ║ █▀▀▀▀▀▀▀▀▀▀▀▀█
█            █ ║          ║          ║          ║          ║          ║          ║          ║          ║          ║          ║          ║          ║          ║ █            █
█            █ ║          ║          ║          ║          ║          ║          ║          ║          ║          ║          ║          ║          ║          ║ █            █
█            █ ╠══════════╬══════════╬══════════╬══════════╬══════════╬══════════╬══════════╬══════════╬══════════╬══════════╬══════════╬══════════╬══════════╣ █            █
█            █ ║░░░░░░░░░░║░░░░░░░░░░║░░░░░░░░░░║░░░░░░░░░░║░░░░░░░░░░║░░░░░░░░░░║░░░░░░░░░░║░░░░░░░░░░║░░░░░░░░░░║░░░░░░░░░░║░░░░░░░░░░║░░░░░░░░░░║░░░░░░░░░░║ █            █
▀▀▀▀▀▀▀▀▀▀▀▀▀▀▀▀▀▀▀▀▀▀▀▀▀▀▀▀▀▀▀▀▀▀▀▀▀▀▀▀▀▀▀▀▀▀▀▀▀▀▀▀▀▀▀▀▀▀▀▀▀▀▀▀▀▀▀▀▀▀▀▀▀▀▀▀▀▀▀▀▀▀▀▀▀▀▀▀▀▀▀▀▀▀▀▀▀▀▀▀▀▀▀▀▀▀▀▀▀▀▀▀▀▀▀▀▀▀▀▀▀▀▀▀▀▀▀▀▀▀▀▀▀▀▀▀▀▀▀▀▀▀▀▀▀▀▀▀▀▀▀▀▀▀▀▀▀▀▀▀▀▀▀▀▀▀▀▀▀▀▀▀▀▀