##########################################################################################################
#     |      |      |      |      |      |      |      |      |      |      |      |                     #
#     |      |      |      |      |      |      |      |      |      |      |      |                     #
#     |      |      |      |      |      |      |      |      |      |      |      |                     #
#                                                                                                        #
#                                                                                                        #                                                                                  #
#                                                                                                        #
#                                                                                                        #
#                                                                                                        #
#                       +----------------------------------------------------+                           #                                                      #
#                                                                                                        #
#                                  < < < < <                                                             #
#                                                                                                        #
#                                                                                                        #
#                        +----------------------------------------------------+                          #
#                                                                                                        #
#                                  > > > > >                                                             #
#                                                                                                        #
#                                                                                                        #
#                                                                                                        #                                                                                                        #
#                        +---------------------------------------------------+                           #                                                    #
#                                                                                                        #
#                                                                                                        #
#                                                                                                        #
#                                                                                                        #
#                                                                                                        #
#     |      |      |      |      |      |      |      |      |      |      |      |                     #
#     |      |      |      |      |      |      |      |      |      |      |      |                     #
#     |      |      |      |      |      |      |      |      |      |      |      |                     #
##########################################################################################################