##########################################################################################################
#      |        |        |        |        |        |        |        |        |        |        |       #
#      |        |        |        |        |        |        |        |        |        |        |       #
#      |        |        |        |        |        |        |        |        |        |        |       #
#      |        |        |        |        |        |        |        |        |        |        |       #
#                                                                                                        #
#                                                                                                        #
#                                                                                                        #
#                                                                                                        #
#                                                                                                        #
#                                                                                                        #
#                    +---------------------------------------------------+                               #
#                                                                        |                               #
#                                            < < < < <                   |                               #
#                                                                        |                               #
#                                                                        |                               # # # # # # # # # # # # # # # # # # # # # # # # # #
#                    +---------------------------------------------------+                            
#                                                                                              > > >
#                                                                                              > > >
#                                                                                              > > >        
#                                                                                                        
#                                                                                                        # # # # # # # # # # # # # # # # # # # # # # # # # # 
#                                                                                                        #
#                                                                                                        #
#                                                                                                        #
#                                                                                                        #
#                                                                                                        #
#                                                                                                        #
#      |        |        |        |        |        |        |        |        |        |        |       #
#      |        |        |        |        |        |        |        |        |        |        |       #
#      |        |        |        |        |        |        |        |        |        |        |       #
#      |        |        |        |        |        |        |        |        |        |        |       #
##########################################################################################################