##########################################################################################################
#      |        |        |        |        |        |        |        |        |        |        |       #
#      |        |        |        |        |        |        |        |        |        |        |       #
#      |        |        |        |        |        |        |        |        |        |        |       #
#      |        |        |        |        |        |        |        |        |        |        |       #
#                                                                                                        #
#                                                                                                        #
#                                                                                                        #
#                                                                                                        #
#                    +---------------------------------------------------+                               #
#                                                                        |                               #
#                                            < < < < <                   |                               #
#                                                                        |                               #
#                                                                        |                               #
#                    +---------------------------------------------------+                               #
#                                                                        |                               #
#                                            > > > > >                   |                               #
#                                                                        |                               #
#                                                                        |                               #
#                    +---------------------------------------------------+                               #
#                                                                                                        #
#                                                                                                        #
#                                                                                                        #
#                                                                                                        #
#                                                                                                        #
#      |        |        |        |        |        |        |        |        |        |        |       #
#      |        |        |        |        |        |        |        |        |        |        |       #
#      |        |        |        |        |        |        |        |        |        |        |       #
#      |        |        |        |        |        |        |        |        |        |        |       #
##########################################################################################################