          ##########################################################################################################
          #      |         |         |         |         |         |         |         |         |         |       #
          #      |         |         |         |         |         |         |         |         |         |       #
          #      |         |         |         |         |         |         |         |         |         |       #
          #      |         |         |         |         |         |         |         |         |         |       #
          #                                                                                                        #
          #                                                                                                        #
          #                                                                                                        #
          #                                                                                                        #
          #                                                                                                        #
          #                                                                                                        #
          #                                                                                                        #
# # # # # #                                                                                                        # # # # # # # # # # # # # # # # # # # # #
                                                                                                                                                            
                                                                                                                                                            
   > > >                                                                                                                                        
                                                                                                                                > > > > > >                          
                                                                                                                                > > > > > >                           
# # # # # #                                                                                                       
          #                                                                                                       
          #                                                                                                       
          #                                                                                                        # # # # # # # # # # # # # # # # # # # # # 
          #                                                                                                        #
          #                                                                                                        #
          #                                                                                                        #
          #      |         |         |         |         |         |         |         |         |         |       #
          #      |         |         |         |         |         |         |         |         |         |       #
          #      |         |         |         |         |         |         |         |         |         |       #
          #      |         |         |         |         |         |         |         |         |         |       #
          ##########################################################################################################