##########################################################################################
#     |      |      |      |      |      |      |      |      |      |      |      |     #
#     |      |      |      |      |      |      |      |      |      |      |      |     #
#     |      |      |      |      |      |      |      |      |      |      |      |     #
#                                                                                        #
#                                                                                        #
#             +------------------------------------------------------------+             #
#                                    <   <   <                                           #
#             +------------------------------------------------------------+             #
#                                    >   >   >                                           #
#             +------------------------------------------------------------+             #
#                                                                                        #
#                                                                                        #
#     |      |      |      |      |      |      |      |      |      |      |      |     #
#     |      |      |      |      |      |      |      |      |      |      |      |     #
#                                                                                        #
#                                                                                        #
#                                                                                        #
#                                                                                        #
#                                                                                        #
#    |      |      |      |      |      |      |      |      |      |      |      |      #
##########################################################################################
