┌──────────────────────────────────────────────────────────────────────────────────────────────────┐
│            │ |""""""""""|"""""""""""""|""""""""""|""""""""""|""""""""""|""""""""""| │            │
│            │ |──────────|─────────────|──────────|──────────|──────────|──────────| │            │
│            │ |          |             |          |          |          |          | │            │
│────────────┘ |          |             |          |          |          |          | └────────────│
│──|────────── |          |             |          |          |          |          | ──────────|──│
│""|                                                                                            |""│
│""|                                                                                            |""│
│──|──────────                                                                        ──────────|──│
│""|                                                                                            |""│
│""|                                                                                            |""│
│""|                        ────────────────────────────────│──────────                         |""│
│──|──────────                                              |         │               ──────────|──│
│""|                                                        |         │                         |""│
│""|                        ────────────────────────────────|─────────│                         |""│
│──|──────────                                              |         │               ──────────|──│
│""|                                                        |         │                         |""│
│""|                        ────────────────────────────────│─────────│                         |""│
│──|──────────                                                                        ──────────|──│
│""|                                                                                            |""│
│""|                                                                                            |""│
│""|                                                                                            |""│
│──|──────────                                                                                  |""│
│              |    |             |          |          |          |          |     | ──────────|──│
│────────────┐ |    |             |          |          |          |          |     | ┌────────────│
│            │ |    |             |          |          |          |          |     | │            │
│            │ |────|─────────────|──────────|──────────|──────────|──────────|─────| │            │
│            │ |""""|"""""""""""""|""""""""""|""""""""""|""""""""""|""""""""""|"""""| │            │
└──────────────────────────────────────────────────────────────────────────────────────────────────┘