▄▄▄▄▄▄▄▄▄▄▄▄▄▄▄▄▄▄▄▄▄▄▄▄▄▄▄▄▄▄▄▄▄▄▄▄▄▄▄▄▄▄▄▄▄▄▄▄▄▄▄▄▄▄▄▄▄▄▄▄▄▄▄▄▄▄▄▄▄▄▄▄▄▄▄▄▄▄▄▄▄▄▄▄▄▄▄▄▄▄▄▄▄▄▄▄▄▄▄▄
█            █ ║░░░░░░░░░░║░░░░░░░░░░░░░║░░░░░░░░░░║░░░░░░░░░░║░░░░░░░░░░║░░░░░░░░░░║ █            █
█            █ ╠══════════╬═════════════╬══════════╬══════════╬══════════╬══════════╬ █            █
█            █ ║          ║             ║          ║          ║          ║          ║ █            █
█▄▄▄▄▄▄▄▄▄▄▄▄█ ║          ║             ║          ║          ║          ║          ║ █▄▄▄▄▄▄▄▄▄▄▄▄█
█══╦══════════ ║          ║             ║          ║          ║          ║          ║ ══════════╦══█
█░░║                                                                                            ║░░█
█░░║                                                                                            ║░░█
█══╬══════════                                                                        ══════════╬══█
█░░║                                                                                            ║░░█
█░░║                                                                                            ║░░█
█░░║                        ▀▀▀▀▀▀▀▀▀▀▀▀▀▀▀▀▀▀▀▀▀▀▀▀▀▀▀▀▀▀▀▀█▀▀▀▀▀▀▀▀▀▀                         ║░░█
█══╬══════════                                              │         █               ══════════╬══█
█░░║                                  <────────────         │         █                         ║░░█
█░░║                        ────────────────────────────────┼─────────█                         ║░░█
█══╬══════════                                              │         █               ══════════╬══█
█░░║                                  ────────────>         │         █                         ║░░█
█░░║                        ▄▄▄▄▄▄▄▄▄▄▄▄▄▄▄▄▄▄▄▄▄▄▄▄▄▄▄▄▄▄▄▄█▄▄▄▄▄▄▄▄▄█                         ║░░█
█══╬══════════                                                                        ══════════╬══█
█░░║                                                                                            ║░░█
█░░║                                                                                            ║░░█
█░░║                                                                                            ║░░█
█══╩══════════                                                                                  ║░░█
█              ║    ║             ║          ║          ║          ║          ║     ║ ══════════╩══█         
█▀▀▀▀▀▀▀▀▀▀▀▀█ ║    ║             ║          ║          ║          ║          ║     ║ █▀▀▀▀▀▀▀▀▀▀▀▀█
█            █ ║    ║             ║          ║          ║          ║          ║     ║ █            █
█            █ ╠════╬═════════════╬══════════╬══════════╬══════════╬══════════╬═════╬ █            █
█            █ ║░░░░║░░░░░░░░░░░░░║░░░░░░░░░░║░░░░░░░░░░║░░░░░░░░░░║░░░░░░░░░░║░░░░░║ █            █
▀▀▀▀▀▀▀▀▀▀▀▀▀▀▀▀▀▀▀▀▀▀▀▀▀▀▀▀▀▀▀▀▀▀▀▀▀▀▀▀▀▀▀▀▀▀▀▀▀▀▀▀▀▀▀▀▀▀▀▀▀▀▀▀▀▀▀▀▀▀▀▀▀▀▀▀▀▀▀▀▀▀▀▀▀▀▀▀▀▀▀▀▀▀▀▀▀▀▀▀