▄▄▄▄▄▄▄▄▄▄▄▄▄▄▄▄▄▄▄▄▄▄▄▄▄▄▄▄▄▄▄▄▄▄▄▄▄▄▄▄▄▄▄▄▄▄▄▄▄▄▄▄▄▄▄▄▄▄▄▄▄▄▄▄▄▄▄▄▄▄▄▄▄▄▄▄▄▄▄▄▄▄▄▄▄▄▄▄▄▄▄▄▄▄▄▄▄▄▄▄▄▄▄▄▄▄▄▄▄▄▄▄▄▄▄▄▄▄
█            █ ║░░░░░░░░░░║░░░░░░░░░░░░░║░░░░░░░░░░║░░░░░░░░░░║░░░░░░░░░░║░░░░░░░░░░║░░░░░░░░░░║░░░░░░║ █            █
█            █ ╠══════════╬═════════════╬══════════╬══════════╬══════════╬══════════╬══════════╬══════╣ █            █
█            █ ║          ║             ║          ║          ║          ║          ║          ║      ║ █            █
█▄▄▄▄▄▄▄▄▄▄▄▄█ ║          ║             ║          ║          ║          ║          ║          ║      ║ █▄▄▄▄▄▄▄▄▄▄▄▄█
█══╦══════════ ║          ║             ║          ║          ║          ║          ║          ║      ║ ══════════╦══█
█░░║                            ║         ║          ║          ║          ║                                      ║░░█
█░░║                            ║         ║          ║          ║          ║                                      ║░░█
█══╬══════════                  ║         ║          ║          ║          ║                            ══════════╬══█
█░░║                            ║═════════╬══════════╬══════════╬══════════╣                                      ║░░█
█░░║                            ║░░░░░░░░░║░░░░░░░░░░║░░░░░░░░░░║░░░░░░░░░░║                                      ║░░█
█░░║                            ▀▀▀▀▀▀▀▀▀▀▀▀▀▀▀▀▀▀▀▀▀▀▀▀▀▀▀▀▀▀▀▀▀▀▀▀▀█▀▀▀▀▀▀▀▀▀█══╬══════════                     ║░░█
█══╬══════════                                                       │         █░░║                     ══════════╬══█
█░░║                                           <────────────         │         █░░║                               ║░░█
█░░║                            ─────────────────────────────────────┼─────────█══╬══════════                     ║░░█
█══╬══════════                                                       │         █░░║                     ══════════╬══█
█░░║                                           ────────────>         │         █░░║                               ║░░█
█░░║                            ▄▄▄▄▄▄▄▄▄▄▄▄▄▄▄▄▄▄▄▄▄▄▄▄▄▄▄▄▄▄▄▄▄▄▄▄▄█▄▄▄▄▄▄▄▄▄█══╩══════════                     ║░░█
█══╬══════════                  ║░░░░░░░░░║░░░░░░░░░░║░░░░░░░░░░║░░░░░░░░░░║                            ══════════╬══█
█░░║                            ║═════════╬══════════╬══════════╬══════════╣                                      ║░░█
█░░║                            ║         ║          ║          ║          ║                                      ║░░█
█░░║                            ║         ║          ║          ║          ║                                      ║░░█
█══╩══════════                  ║         ║          ║          ║          ║                            ══════════╩══█
█              ║    ║             ║          ║          ║          ║          ║          ║            ║              █
█▀▀▀▀▀▀▀▀▀▀▀▀█ ║    ║             ║          ║          ║          ║          ║          ║            ║ █▀▀▀▀▀▀▀▀▀▀▀▀█
█            █ ║    ║             ║          ║          ║          ║          ║          ║            ║ █            █
█            █ ╠════╬═════════════╬══════════╬══════════╬══════════╬══════════╬══════════╬════════════╣ █            █
█            █ ║░░░░║░░░░░░░░░░░░░║░░░░░░░░░░║░░░░░░░░░░║░░░░░░░░░░║░░░░░░░░░░║░░░░░░░░░░║░░░░░░░░░░░░║ █            █
▀▀▀▀▀▀▀▀▀▀▀▀▀▀▀▀▀▀▀▀▀▀▀▀▀▀▀▀▀▀▀▀▀▀▀▀▀▀▀▀▀▀▀▀▀▀▀▀▀▀▀▀▀▀▀▀▀▀▀▀▀▀▀▀▀▀▀▀▀▀▀▀▀▀▀▀▀▀▀▀▀▀▀▀▀▀▀▀▀▀▀▀▀▀▀▀▀▀▀▀▀▀▀▀▀▀▀▀▀▀▀▀▀▀▀▀▀▀